16 16 3
1 1 1 1 1 1 1 1 1 1 1 1 1 1 1 1
1 0 0 0 1 0 0 0 4 1 1 1 1 1 1 1
1 3 2 0 0 0 0 0 1 1 1 1 1 1 1 1
1 0 0 5 1 1 5 0 1 1 1 1 1 1 1 1
1 1 0 5 1 1 5 0 1 1 1 1 1 1 1 1
1 1 0 5 5 5 5 0 0 1 1 1 1 1 1 1
1 1 1 0 0 2 0 0 0 1 1 1 1 1 1 1
1 4 0 0 0 1 1 4 0 0 0 0 0 5 5 1
1 1 1 5 1 1 1 1 1 1 5 0 0 1 1 1
1 1 1 1 1 1 1 1 1 1 5 0 0 1 1 1
1 1 1 1 1 1 1 1 1 1 5 2 0 5 5 1
1 1 1 1 5 5 1 1 1 1 5 0 0 1 1 1
1 1 5 5 0 0 0 0 0 0 5 1 1 1 1 1
1 1 1 1 0 0 1 1 1 1 1 1 1 1 1 1
1 1 1 1 0 0 0 6 1 1 1 1 1 1 1 1
1 1 1 1 1 1 1 1 1 1 1 1 1 1 1 1
