10 10 3
1 1 1 1 1 1 1 1 1 1
1 0 0 4 1 5 0 0 4 1
1 3 2 0 1 1 0 2 1 1
1 0 0 5 1 1 0 0 1 1
1 1 0 5 1 1 0 0 1 1
1 1 0 5 0 0 0 5 5 1
1 1 1 5 2 4 0 5 5 1
1 6 5 0 0 1 1 5 5 1
1 1 1 0 1 1 1 1 1 1
1 1 1 1 1 1 1 1 1 1
